NO textures/c3d_castleTownWall01.xpm
SO textures/c3d_castleTownWall02.xpm
WE textures/c3d_castleTownWall03.xpm
EA textures/c3d_castleTownWall04.xpm

F 220,100,0
C 135,206,235

1111111111
1000000001
1000110001
1000N10001
1000000001
1000010001
1000000001
1000000001
1000000001
1111111111
