SO ./textures/c3d_castleTownWall01.xpm
WE ./textures/c3d_castleTownWall02.xpm
EA ./textures/c3d_castleTownWall03.xpm
NO ./textures/c3d_castleTownWall04.xpm

F 0,0,0
C 45,45,45

1111111111111111111
10W1001001001020001
1011002001000021001
1001001001011121111
1001111000101001001
1002000000000001001
1001111111111001001
1111000000000001211
1000000001000000001
1111111111111111111