SO ./textures/c3d_castleTownWall01.xpm
WE ./textures/c3d_castleTownWall02.xpm
EA ./textures/c3d_castleTownWall03.xpm
NO ./textures/c3d_castleTownWall04.xpm

F 0,0,0
C 45,45,45

1111111111111111111111111111111111111111111111111111111111111111111111111111111
1E00000000000000000000000000000000000000000000000000000000000000000000000000001
1000000000000000000000000000000000000000000000000000000000000000000000000000001
1000000000000000000000000000000000000000000000000000000000000000000000000000000
1111111111111111111111111111111111111111111111111111111111111111111111111111111