SO ./textures/c3d_castleTownWall01.xpm
WE ./textures/c3d_castleTownWall02.xpm
EA ./textures/c3d_castleTownWall03.xpm
NO ./textures/c3d_castleTownWall04.xpm

F 0,0,0
C 45,45,45

1111111111111111111
10W1001001001000001
1011000001000001001
1001001001011101111
1001111000101001001
1000000000000001001
1001111111111001001
1111000000000001011
1000000001000000001
1111111111111111111