SO ./textures/c3d_castleTownWall01.xpm
WE ./textures/c3d_castleTownWall02.xpm
EA ./textures/c3d_castleTownWall03.xpm
NO ./textures/c3d_castleTownWall04.xpm

F 127,0,127
C 45,255,0

1111111111111111111111111111111111111111111111111111
1001001E00000000100010000001000100000010001000000001
1011000000000000000010000000000100000000001000000001
1001011100110000100011110001000111100010001111000111
1001101000000000100000000001000000000010000000000001
1111111111111111111111111111111111111111111111111111